###################################################################################
#.....#.#.#.......#.#.......#.#...............#.............#...#.....#...........#
..#####.#.#.#####.#.#.###.###.#.###############.###.#########.###.#####.###########
#......S........#.......#.#.#.....................#...#.#.....#...................#
#.#.#####.#.###############.#.###.#####.###.#.#########.#.#####.###################
#.#.....#.#...#.................#.....#...#.#.....................................#
###.#.###.###.#.#####.#########.#########.###############.#######.#################
#...#.#.#...#.#.....#.........#.#.......#...............#.......#.......#.........#
#.#.#.#.#######.#################.###.#########.#.#.#.#########.#.#######.#########
#.#.#.....#.........................#.........#.#.#.#.........#.#...............#.#
###.#.#.#.#.#####.#.#.#.#####.#######.#.#.###########.#.#.###.#.#########.#######.#
#...#.#.#.......#.#.#.#.....#.......#.#.#.......#...#.#.#...#.#...#.....#.......#.#
#.#.#.###.#.###.###.#.#.#.#.#########.###########.###.###.#########.#####.#.#.###.#
#.#.#...#.#...#...#.#.#.#.#.#.......#...............#...#...............#.#.#.#.#.#
#.#.#.#.###.#.###############.###########.#######.#.#####.#########.###########.#.#
#.#.#.#...#.#...........#.............#.#.......#.#.....#...#.....#.#...#...#.....#
#.###.#.#.#.#####.#######.#####.#######.###.###.#####.#######.#####.#.###.###.#####
#.#...#.#.#.....#...#.#.......#...........#...#...#.#.#.#.#.......#.....#.....#.#.#
#######.#.###.#.#.###.#.###.#.###.#.#.#####.#.#.###.###.#.#.#####.#######.#####.#.#
#.......#...#.#.#.........#.#...#.#.#.....#.#.#.................#.................#
#.#.###.#.#.#.#######.#########.#.#####.#########.#######.###########.#.#.#######.#
#.#.#...#.#.#.......#.........#.#.....#.........#.......#...........#.#.#.......#.#
#.#.###.#.#.#.#.#.#.#.#.#####.#.#.###.#.###.###############.#.#######.###.#.#######
#.#...#.#.#.#.#.#.#.#.#.....#.#.#...#.#...#...........#...#.#.......#.#.#.#.......#
#.#.#.#.#####.#.#####.#.###.#.#######.#.###.#########.#.#####.###.#####.###########
#.#.#.#.....#.#...#...#...#.#.......#.#...#.........#.......#...#.#.#.#...........#
#.#####.#####.#.#.#.#.#.#######.#.#.###.#.#.#.#.#.#################.#.#.#####.###.#
#.#.........#.#.#.#.#.#.......#.#.#.#...#.#.#.#.#...............#.#.#.......#...#.#
#.#.#.#.#.#####.#####.#.#.#.#.#.###.###.#.#.###.#######.#.#######.#.#.#############
#.#.#.#.#...#.......#.#.#.#.#.#...#...#.#.#...#.......#.#.......................#.#
#.#####.#.#####.###.#########.#.#########.#.###.#####.###.#.#####.#.#.#.#.#####.#.#
#...#...#...#.....#.........#.#.........#.#...#.....#...#.#.....#.#.#.#.#.....#...#
#.#.###.#.#.#.#.#######################.#.#.###.#.#####.###.#######.#.#.###########
#.#.#...#.#.#.#.......................#.#.#...#.#.....#...#.....#...#.#...........#
#.#.#.#.#.###.#.#.#.###.#.#####.#.#.###.#.#.#.#.#.#.###.#.#####.###.#.#.###.#.#.###
#.#.#.#.#.#.#.#.#.#...#.#.....#.#.#...#.#.#.#.#.#.#...#.#.....#...#.#.#...#.#.#...#
#.#.#####.#.#.#.#.#.#.#.###.#.#.#.#####.###.#.###.###.###.#.#.#.#.#.###.###.#.###.#
#.#...#...#...#.#.#.#.#...#.#.#.#.....#...#.#.#.....#...#.#.#.#.#.#...#...#.#...#.#
#.#.#.#.#.#####.#.#.#.#.###############.#######.#.#.#.#.#.#.#######.#.#.###.#.#.###
#.#.#.#.#.#.....#.#.#.#...............#.....#...#.#.#.#.#.#.......#.#.#...#.#.#...#
#.#.#.#.###.#.#.###.###.#.#####.#.###.###.#######.#.###.#.#.#####.#.#.#.#.#.#.#.#.#
#.#.#.#.#...#.#...#.#...#.....#.#...#...#.#.....#.#...#.#.#.....#.#.#.#.#.#.#.#.#.#
###.#.#.#.###.#.#.#.#.#.#####.#############.###.###.###.###.###.#####.###.#.#####.#
#...#.#.#.#...#.#.#.#.#.....#.................#...#...#.#.....#.....#...#.#.....#.#
#.#.#.#.#####.#.#.#.#.#.#####.#.#####.#######.###.#.#######.#.###.###.#.#.#.#.#.#.#
#.#.#.#.#.....#.#.#.#.#.....#.#.#.#.#.......#...#.#.......#.#...#...#.#.#.#.#.#.#.#
#.#.#.###.###.#.#.#.###.#.#.#####.#.#######.#####.#.#######.#.#.#.#.#####.#.#.###.#
#.#.#.#...#...#.#.#.#...#.#...............#.#.#.#.#.......#.#.#.#.#.....#.#.#...#.#
#.#.#.###.###.#########.#.#############.#####.#.#.#.#.#.#.#.#.#.#.#####.#.###.###.#
#.#.#.#...#.........#...#.............#...#.....#.#.#.#.#.#.#.#.#.....#.#...#...#.#
#.#####.#####.#########.#.###.###.#.#.###.#.#########.#.#.#.#.###.###.#############
#...#...#...........#.#.#...#...#.#.#...#...........#.#.#.#.#...#...#.............#
#.#.#####.#.#.#.#.#.#.#.#.#.###.#.#.###.###.###.###.#.###.#.###.###.#########.#####
#.#.#.....#.#.#.#.#...#.#.#...#.#.#...#...#...#...#.#...#.#...#...#.........#.....#
#.#.#.#.###.#.#.###.#.###.#.###.#.#.#########.#.#.###.#.###.#####.#######.#.#.#.###
#.#.#.#.#...#.#.#...#.#...#...#.#.#.........#.#.#...#.#...#.....#.......#.#.#.#...#
#.#.#.#.#######.###.#.###.#####.###.#.###.#.###.#.#.#.#####.#.#.#.#.#.#.#.###.#.#.#
#.#.#.#.#.........#.#...#.....#...#.#...#.#...#.#.#.#.....#.#.#.#.#.#.#.#...#.#.#.#
#.#.#.#.#####.#.#.#.#.###.#####.#.#.#.#.#.#.#.###.#.#.###.#.###.###.#.#.#.###.#.###
#.#.#.#.#.....#.#.#.#...#.....#.#.#.#.#.#.#.#...#.#.#...#.#...#...#.#.#.#...#.#...#
#.#.#.#.#####.#.#.#.#.###.#######.###.#.#.#.###.#.#####.#.#.#.#########.#.#.#.#.###
#.#.#.#.#.....#.#.#.#...#.....#.....#.#.#.#...#.#.....#.#.#.#.........#.#.#.#.#...#
#.#.#.#.#.#.###.#.#.#.###.###.#####.#.#.#.#.#####.#####.#.###.#########.#.#.#.#.###
#.#.#.#.#.#.#...#.#.#.#.....#.....#.#.#.#.#.....#.....#.#...#.........#.#.#.#.#...#
#####.#.#.#.#.#.###.#.#.#.#####.#.###.###.#.#.###########.#.#.#########.#.#####.#.#
#.....#.#.#.#.#...#.#.#.#.....#.#...#...#.#.#...........#.#.#.......#.#.#.....#.#.#
#.#.#.#.#.#.###.#####.###.###########.#.#.#.#.#####.#.#.#.#.#.#.###.#.#######.###.#
#.#.#.#.#.#.#...#.......#...........#.#.#.#.#.....#.#.#.#.#.#.#...#.........#.#.#.#
#.###.#.###.#.#.###.#.#.#.#.#############.#.#.#.#####.#####.#.#.#######.#######.###
#.#...#.#...#.#.#...#.#.#.#.............#.#.#.#.....#.#.....#.#.......#...........#
#.###.#.#######.###.#.###.###.#####.#.#.#.#.#.#.#.###.#######.###.###############.#
#.#...#.#.......#...#.#.....#.....#.#.#.#.#.#.#.#...#.#.#...#...#.............#.#.#
#.###.#.#.###.###.#.#.###.#.#.#.###########.###########.#.#######.#######.#####.###
#.#...#.#.#...#...#.#...#.#.#.#.....#.#.#.#...................#.#.......#.......#.#
#.#.#.#######.###.#.###.#.#.#.#####.#.#.#.#####.#.#############.#################.#
#.#.#...#.....#...#...#.#.#.#.....#.....#.....#.#.......#...#.....................#
#.#.#.#.#####.#.#.#.###.#.#.#.#.#.#######.#####.###.#.###.###.###.###########.#####
#.#.#.#.#.....#.#.#...#.#.#.#.#.#.............#.#.#.#...#.......#.......#...#...#.#
#.#.#.#.###.#.#####.#.#.#.#.#.#.###.#############.#######.#####.#######.#.#######.#
#.#.#.#.#.#.#.#...#.#.#.#.#.#.#...#...........#...#.....#.....#.......#.....T...#.#
#########.#.#.###.#.#######.#.#.#########.#####.###.#####.#############.#########.#
#...........#...#.........#.#.#.........#.............................#............
###################################################################################
